11111111111111111111
11111111111111111111
00000000000000000100
11111110010011111000
00000010010010011110
00000010010010011110
00000010010010011110
00000000010010011110
00000000010010001110
00000010010010011110
00000010010010011110
00000010010010011110
11111110011110011110
00000000000000000100
11111110011111111100
00000000000000000000