00000000000000000000
11111111111111111000
00000000000000000100
11111110011111111000
00000010010010011110
00000010010010011110
00000010010010011110
00000010010010011110
00000010010010001110
00000010010010011110
00000010010010011110
00000010010010011110
11111110011110011110
00000000000000000100
11111110011111111100
00000000000000000000