10000000000000000000
10000000000000000000
10000000000000000000
10000000000000000000
11111011110000000000
10000000000000000000
10000000000000000000
10000000000000000000
10000000000000000000
10000000000000000000
10000000000000000000
10000000000000000000
10000000000000000000
10000000000000000000
10000000000000000000
11111111111111111111