00000000000000000000
11111111100111111110
11111111100111111110
11111111100111111110
11111111100111111110
11111111100111111110
11111111100111111110
00000000000000000000
00000000000000000000
01111111100111111110
01111111100111111110
01111111100111111110
01111111100111111110
01111111100111111110
01111111100111111110
00000000000000000000