00000000022110000000
00000000011110000000
00000000001111000000
00000000000111100000
01000000000011110000
01100000000001111000
01110000000000111100
21111001111100011112
21111000111110011112
00111100000000001110
00011110000000000110
00001111000000000010
00000111100000000000
00000011110000000000
00000001111000000000
00000001122000000000