11110000111110000110
11111000011100001111
11111100001000011111
11111110000000111111
11111110000000111111
11111000100100011111
11110001100110001111
00000011100111000000
00000111100111100000
11111111100111111111
11111111100111111111
11111111100111111111
00000000000000000000
00000000000000000000
11111111100111111111
11111111100111111111